石斛: 川石斛、 川斛、 金石斛、 金斛
旱莲草: 旱莲草
鸡子黄: 生鸡子黄
虎骨: 生虎胫骨、 生虎骨、 虎骨胶
半夏: 炒半夏、 熟半夏、 半夏曲
鳖甲: 鳖甲胶、 生鳖甲
柏子仁: 柏子仁、 柏子霜、 炒柏子仁
竹叶: 卷心竹叶、 竹叶心
淡菜: 淡菜
石菖蒲: 石菖蒲、 菖蒲、 菖蒲根
茯神: 茯神、 白茯神、 云茯神、 抱木茯神
小胡麻: 三角胡麻、 茺蔚子
郁金: 郁金
石决明: 石决明、 九孔石决明
猪胆汁: 猪胆汁
黑芝麻: 黑芝麻、 巨胜子
草决明: 草决明
菊花: 黄甘菊、 炒菊花、 青菊叶、 菊花汁、 甘菊、 甘菊炭、 菊花炭
龙骨: 龙骨
甘草: 炙黑甘草、 炙甘草、 炙草
人参: 人参
芦根: 芦根汁
川羌: 羌活
百合: 干百合、 白花百合
橘红: 橘红、 化橘红、 广橘红
枳实: 枳实
钩藤: 钩藤、 嫩钩藤
羚羊角: 羚羊角、 羚角
萆薢: 川萆薢
当归: 归身
大枣: 大枣、 南枣、 枣、 南枣肉
片姜黄: 片姜黄
关白附: 竹节白附子
川芎: 川芎
白术: 白术、 于术
栀子: 黑山栀
犀角: 犀角
磁石: 磁石
小茴香: 小茴
杏仁: 甜杏仁
沙苑子: 沙苑、 生沙苑
龟甲: 龟腹甲心、 龟板、 炙龟甲、 龟版胶、 生龟甲
桑枝: 桑枝
糯稻根: 糯稻根
银花: 鲜银花
远志: 远志、 炒远志、 远志肉
地骨皮: 地骨皮
柿蒂: 柿霜
蒺藜: 白蒺藜
陈皮: 广皮、 新会皮、 广皮肉、 广皮白
黄芪: 黄芪、 生黄芪、 黄芪皮
谷芽: 生谷芽
白酒: 白酒
熟地: 熟地、 熟地炭、 九制熟地
桑寄生: 桑寄生
牡蛎: 牡蛎、 生牡蛎
肉苁蓉: 淡苁蓉干、 干苁蓉、 苁蓉、 淡苁蓉、 淡肉苁蓉、 咸苁蓉
阿胶: 阿胶、 清阿胶
知母: 知母
秦皮: 真北秦皮
秋石: 真秋石
黄连: 川连、 川黄连
夏枯草: 夏枯草
生姜: 姜、 姜汁
茯苓: 茯苓、 赤茯苓、 白茯苓、 云苓
桂枝: 桂枝、 桂枝木
桂圆肉: 桂圆肉
黄柏: 黄柏
丹皮: 丹皮
附子: 附子、 川熟附、 淡附子
玉竹: 玉竹
丹参: 丹参
干姜: 煨姜
南沙参: 白沙参、 长条白沙参、 长白沙参
火麻仁: 麻仁
天冬: 天冬
梨: 甜梨汁、 甜梨
连翘: 连翘心
白扁豆: 白扁豆、 生白扁豆、 生白扁豆皮、 生扁豆
玄参: 玄参心
乌梅: 乌梅肉
巴戟天: 巴戟天、 巴戟
何首乌: 制首乌、 九制首乌、 熟首乌
木瓜: 木瓜
天麻: 明天麻
白芍: 白芍、 生白芍
天花粉: 花粉
竹沥: 鲜竹沥
浮小麦: 小麦、 陈小麦
女贞子: 女贞实
天南星: 南星、 胆星、 陈胆星
桑叶: 桑叶、 童桑、 冬桑叶、 九蒸桑叶、 九蒸冬桑叶
薏苡仁: 苡米、 苡仁
防风: 防风
桔梗: 桔梗
盐: 青盐
怀牛膝: 怀牛膝、 牛膝、 牛膝炭
麦冬: 麦门冬、 炒麦冬
地栗粉: 地栗粉
香附: 香附汁
酸枣仁: 酸枣仁、 枣仁
五味子: 五味
北沙参: 北沙参、 沙参、 真北沙参
山萸肉: 萸肉、 萸肉炭
浙贝: 象贝母
川贝: 川贝母
甘蔗: 蔗浆、 甘蔗浆、 青蔗浆
砂仁: 砂仁
金箔: 金箔
黑稆豆: 小黑豆皮、 黑稆豆皮、 稆豆皮、 小黑稆豆皮
枸杞子: 枸杞子、 炒杞子、 杞子、 枸杞、 枸杞子炭
朱砂: 朱砂
生地: 生地黄、 鲜生地、 地黄、 细生地、 炒生地
