七福饮: 人参 熟地 当归 白术 枣仁 远志 炙草
七香饼: 香附（一两二钱） 丁香皮（一两二钱） 甘松（八钱） 益智仁（六钱） 砂仁（二钱） 蓬术（二钱） 广皮（二钱）
万氏牛黄清心丸: 黄连 黄芩 山栀 郁金 辰砂 西牛黄
三才封髓丹: 天冬 熟地 人参 黄柏 砂仁 甘草
三才汤: 天冬 熟地 人参
三拗汤: 麻黄 杏仁 甘草
三豆饮: 大黑豆 赤小豆 绿豆 甘草
下瘀血汤: 大黄 桃仁 蟅虫
东垣和中丸: 人参 白术 炮姜 炙草 陈皮 木瓜
东垣清心凉膈散: 连翘 薄荷 黄芩 山栀 桔梗 甘草 竹叶
两仪膏: 人参 熟地
丹溪滋阴大补丸: 熟地 山药 牛膝 枸杞 山萸 茯苓 杜仲 远志 五味子 楮实 小茴 巴戟 苁蓉 石菖蒲 去楮实
乌梅丸: 乌梅 人参 当归 黄连 黄柏 桂枝 干姜 蜀椒 附子 细辛
乌鲗鱼骨丸: 乌鲗鱼骨 茜草根 雀卵 鲍鱼汤
乌鸡煎丸: 乌骨雄鸡（一只） 乌药 蛇床子 丹皮 白术 人参 黄芪（各一两） 茅术（米泔浸一两半） 海桐皮 红花 白芍 肉桂 附子（炮） 川乌（炮） 莪术 陈皮（各二两） 熟地（洗焙） 延胡 木香 肉果 草果 琥珀（各五钱）
二至丸: 冬青子 旱莲草
二贤散: 陈皮 甘草
二阴煎: 生地 麦冬 枣仁 甘草 玄参 茯苓 黄芩 木通
二陈汤: 半夏 陈皮 茯苓 甘草 生姜
五仁丸: 火麻仁 郁李仁 柏子仁 松子仁 桃仁
五子五皮汤: 即五皮饮加杏仁苏子葶苈白芥子卜子
五痫丸: 朱砂 真珠 雄黄 水银 黑铅
五磨饮子: 乌药 沉香 槟榔 枳实 木香
五积散: 白芷 陈皮 厚朴 当归 川芎 芍药 茯苓 桔梗 苍术 枳壳 半夏 麻黄 干姜 肉桂 甘草 姜 葱
五苓散: 猪苓 茯苓 泽泻 白术 桂枝
交加散: 生地 生姜
人参丸: 人参 茯苓 茯神 枣仁 远志 益智仁 牡蛎 朱砂
人参养荣汤: 人参 茯苓 白术 甘草 当归 白芍 熟地 黄芪 肉桂 五味 远志 陈皮 加姜、枣
人参四逆汤: 甘草 干姜 附子 加人参
人参固本丸: 人参 天冬 麦冬 生地 熟地
人参建中汤: 白芍 桂枝 炙草 生姜 大枣 饴糖 人参
人参温胆汤: 陈皮 半夏 茯苓 甘草 枳实 竹茹 人参
人参败毒散: 人参 羌活 独活 柴胡 前胡 川芎 桔梗 茯苓 甘草 枳壳 薄荷 生姜
何人饮: 何首乌 人参 当归 陈皮 煨姜
侯氏黑散: 菊花 白术 防风 桔梗 黄芩 细辛 茯苓 牡蛎 人参 矾石 当归 干姜 川芎 桂枝
保和丸: 山楂 神曲 茯苓 半夏 陈皮 卜子 连翘
保阴煎: 生地 熟地 白芍 山药 川断 黄芩 黄柏 甘草
六君子汤: 人参 茯苓 白术 甘草 陈皮 半夏
六味地黄丸: 熟地 山药 山茱萸 丹皮 茯苓 泽泻
六味地黄汤: 熟地 山药 山茱萸 丹皮 茯苓 泽泻
六和汤: 砂仁 藿香 厚朴 杏仁 半夏 扁豆 木瓜 人参 赤茯苓 白术 甘草 姜 枣
六柱饮: 人参 附子 茯苓 木香 肉豆蔻 诃子
六神散: 人参 茯苓 白术 甘草 山药 扁豆 姜 枣
六神汤: 人参 茯苓 白术 甘草 山药 扁豆
兰草汤: 兰草
养营汤: 即人参养营汤
凉膈散: 连翘 大黄 芒硝 甘草 山栀 黄芩 薄荷
加味肾气丸: 熟地 山药 山茱萸 丹皮 茯苓 泽泻 附子 肉桂 车前 牛膝
加味逍遥散: 柴胡 当归 白芍 白术 茯苓 甘草 煨姜 薄荷 丹皮 山栀
加桂理中汤: 人参 甘草 白术 干姜 加桂
十味温胆汤: 陈皮 半夏 茯苓 甘草 枳实 竹茹 人参 远志 枣仁 熟地
千金苇茎汤: 苇茎 苡仁 桃仁 瓜瓣
千金鳖甲煎丸: 鳖甲 乌扇 黄芩 柴胡 干姜 大黄 芍药 桂枝 葶苈 石苇 厚朴 丹皮 瞿麦 紫威 半夏 人参 土鳖虫 阿胶 蜂窠 蜣螂 桃仁 灶下灰 清酒 海藻 大戟
升阳益胃汤: 羌活 防风 独活 白芍（各五钱） 广皮（四钱） 黄芪（二两） 人参 半夏 炙甘草（各五钱） 柴胡 黄连（各二钱） 白术 茯苓 泽泻（各三钱）
半夏泻心汤: 半夏 黄芩 黄连 人参 炙草 干姜 大枣
半硫丸: 半夏 硫黄
华盖散: 麻黄 苏子 桑皮 杏仁 赤苓 橘红 甘草
厚朴三物汤: 厚朴 大黄 枳实
厚朴温中汤: 厚朴 陈皮 甘草 木香 草蔻 干姜 茯苓
参归桂枝汤: 桂枝 白芍 炙草 生姜 大枣 人参 当归
参芪建中汤: 白芍 桂枝 炙草 生姜 大枣 饴糖 人参 黄芪
参苓白术散: 人参 茯苓 白术 甘草 山药 扁豆 苡仁 建莲 砂仁 桔梗 陈皮
参附汤: 人参 制附子
参附汤: 黄芪 制附子 生姜
又名复脉汤: 炙草 桂枝 人参 麻仁 生地 阿胶 麦冬 生姜 大枣
右归丸: 熟地 山药 枸杞 山萸 菟丝子 鹿角胶 杜仲 当归 肉桂 附子
右归饮: 熟地 山药 枸杞 炙草 山萸  杜仲 肉桂 附子
吴茱萸汤: 吴茱萸 人参 生姜 大枣
吴萸理中汤: 人参 甘草 白术 干姜 吴萸
和中丸: 白术 厚朴 陈皮 半夏 槟榔 枳实 炙草 木香
四兽饮: 人参 茯苓 白术 甘草 陈皮 半夏 乌梅 草果 生姜 大枣
四君子汤: 人参 茯苓 白术 甘草
四君子汤: 人参 茯苓 白术 甘草
四斤丸: 木瓜 天麻 苁蓉 牛膝 附子 虎骨 乳香 没药
四柱饮: 人参 附子 茯苓 木香
四物汤: 生地 当归 白芍 川芎
四神丸: 破故纸 五味 肉果 吴萸
四苓散: 猪苓 茯苓 泽泻 白术
四逆散: 柴胡 枳实 白芍 甘草
四逆汤: 甘草 干姜 附子
四顺清凉饮: 大黄 当归 芍药 甘草
回生丹: 大黑豆（三升用水浸取壳用绢袋盛壳用豆煮熟去豆不用将壳晒干其汁留用） 红花（三两炒黄色入好酒四碗煎十余滚去渣存汁听用） 苏木（三两河水五碗煎汁三碗听用） 大黄（一斤为末） 陈米醋 人参（二两） 川芎 当归 熟地 茯苓 香附 延胡 苍术（米泔浸炒） 桃仁 蒲黄（各一两） 乌药（二两半） 牛膝 地榆 橘红 白芍 羌活 炙草 五灵脂 山萸 三棱（各五钱） 良姜 木香（各四钱） 木瓜 青皮 白术（各三钱） 益母草（二两） 乳香 没药（各二钱） 马鞭草（五钱） 秋葵子（三钱）
固阴煎: 人参 熟地 山药 山萸 远志 炙草 五味 菟丝子
圣济透关散: 雄黄 猪牙皂荚 藜芦
地黄饮子: 熟地 巴戟 山萸 苁蓉 附子 官桂 石斛 茯苓 菖蒲 远志 麦冬 五味
坎气丹: 坎气 人乳粉 熟地 人参 枸杞子
坎气汤: 坎气 人乳粉 熟地 人参 枸杞子
外台茯苓饮: 茯苓 人参 白术 枳实 橘皮 生姜
大半夏汤: 半夏 人参 白蜜
大和中饮: 陈皮 枳实 砂仁 麦芽 厚朴 山楂 泽泻
大补阴丸: 黄柏 知母 熟地 龟板 猪脊髓
大造丸: 紫河车 龟板 人参 熟地 天冬 麦冬 黄柏 牛膝 杜仲
大顺散: 干姜 肉桂 杏仁 甘草
大黄牡丹汤: 大黄 丹皮 桃仁 瓜子 芒硝
大黄黄连泻心汤: 大黄 黄连
天水散: 即六一散
天真丸: 精羊肉 肉苁蓉 山药 当归 天冬 黄芪 人参 白术
失笑散: 蒲黄 五灵脂
妙香丸: 巴豆（三百十五粒去皮心膜炒熟研如面） 牛黄（研） 龙脑（研） 麝香（研） 轻粉（研各三两） 朱砂（研飞九两） 真金箔（九十片）
威喜丸: 茯苓 猪苓 黄蜡
子和导水丸: 大黄 黄芩 滑石 黑丑
安胃丸: 乌梅 川椒 附子 桂枝 干姜（各一两） 黄柏（二两） 黄连（五钱） 川楝子肉 广皮 青皮（各二两） 白芍（三两） 人参（量加如有邪者可勿用）
安蛔丸: 即理中安蛔丸
家韭子丸: 家韭子 鹿茸 肉苁蓉 牛膝 菟丝子 熟地 当归 巴戟 杜仲 石斛 肉桂 炮姜
导赤散: 生地 木通 甘草梢 淡竹叶
寿脾煎: 人参 白术 炙草 当归 山药 枣仁 炮姜 建莲肉 远志
小半夏汤: 半夏 生姜
小建中汤: 白芍 桂枝 炙草 生姜 大枣 饴糖
小温中丸: 白术（二两） 茯苓（一两） 陈皮（一两） 熟半夏（一两） 甘草（三钱） 神曲（炒一两） 生香附（一两半） 苦参（炒五钱） 黄连（炒五钱） 针砂（醋炒红研如飞面一两半）
小青龙汤: 麻黄 桂枝 白芍 干姜 细辛 五味子 甘草 半夏
崔氏八味丸: 干地黄 山茱萸 山药 丹皮 茯苓 泽泻 附子 桂枝
川芎茶调散: 川芎 薄荷 荆芥 羌活 白芷 甘草 防风 细辛
左归丸: 熟地 山药 枸杞 山萸 牛膝 菟丝子 鹿角胶 龟胶
左归饮: 熟地 山药 枸杞 炙草 茯苓 山萸
左金丸: 黄连 吴萸
平胃散: 苍术 厚朴 陈皮 甘草
异功散: 人参 茯苓 白术 甘草 陈皮
张子和桂苓甘露饮: 滑石 石膏 寒水石 甘草 白术 茯苓 泽泻 肉桂 人参 干葛 藿香 木香
张子和玉烛散: 归尾 生地 川芎 赤芍 大黄 芒硝 甘草
归气饮: 熟地 茯苓 扁豆 炮姜 丁香 藿香 炙草 陈皮
归脾丸: 人参 白术 茯神 枣仁 龙眼肉 黄芪 当归 远志 木香 炙草 生姜 大枣 料作丸
归脾汤: 人参 白术 茯神 枣仁 龙眼肉 黄芪 当归 远志 木香 炙草 生姜 大枣
归芍异功散: 即异功散加当归 白芍
归芪建中汤: 白芍 桂枝 炙草 生姜 大枣 饴糖 当归 黄芪
归芪异功散: 人参 茯苓 白术 甘草 陈皮 当归 黄芪
当归建中汤: 白芍 桂枝 炙草 生姜 大枣 饴糖 当归
当归桂枝汤: 桂枝 白芍 炙草 生姜 大枣 当归
当归生姜羊肉汤: 当归 生姜 羊肉
当归龙荟丸: 当归 龙胆草 山栀 黄连 黄柏 黄芩 大黄 青黛 芦荟 木香 麝香
戊己汤: 黄连 吴萸 白芍
戊己汤: 人参 茯苓 白术 甘草 陈皮 白芍
指迷丸 茯苓丸: 即指迷茯苓丸
控涎丹: 甘遂 大戟 白芥子
斑龙丸: 鹿角胶 鹿角霜 熟地 菟丝子 柏子仁
斑龙二至百补丸: 鹿角 黄精 杞子 熟地 菟丝子 金樱子 天冬 麦冬 牛膝 楮实子 龙眼肉
旋覆花代赭石汤: 旋覆花 代赭石 人参 半夏 甘草 生姜 大枣
旋覆花汤: 旋覆花 葱 新绛
星附六君子汤: 人参 茯苓 白术 甘草 陈皮 半夏 制南星 白附子
普济消毒饮: 黄芩 黄连 陈皮 甘草 玄参 连翘 板蓝根 牛蒡 薄荷 僵蚕 升麻 柴胡 桔梗 马勃
更衣丸: 朱砂（五钱研） 芦荟（七钱研）
木防己汤: 木防己 石膏 桂枝 人参
本事方神效散: 白海浮石 蛤粉 蝉蜕 大鲫鱼胆
术菟丸: 白术 菟丝
术附汤: 白术 附子 甘草 生姜 大枣
朱砂安神丸: 朱砂 黄连 生地 当归 甘草
来复丹: 玄精石 硫黄 硝石 五灵脂 青皮 陈皮
枕中丹: 龙骨 龟板 远志 菖蒲
柏子仁丸: 柏仁 牛膝 卷柏 泽兰 续断 熟地
柏子仁丸: 柏子仁 人参 白术 半夏 北味 牡蛎 麻黄根 麦麸
栀子豉汤: 栀子 香豉
桂枝加附子汤: 桂枝 白芍 炙草 生姜 大枣 附子
桂枝加龙骨牡蛎汤: 桂枝 白芍 炙草 生姜 大枣 龙骨 牡蛎
桂枝去芍药加蜀漆龙骨牡蛎救逆汤: 桂枝 炙草 生姜 大枣 蜀漆 龙骨 牡蛎
桂枝汤: 桂枝 白芍 炙草 生姜 大枣
桂枝附子汤: 桂枝 附子 甘草 生姜 大枣
桂枝黄连汤: 黄连 桂枝 干姜 人参 半夏 炙草
桂苓丸: 肉桂 茯苓
桂苓五味甘草汤: 桂枝 茯苓 五味 甘草
桂苓甘露饮: 生地 熟地 天冬 麦冬 石斛 茵陈 黄芩 枳壳 枇杷叶 甘草 桂枝 茯苓
桃仁承气汤: 桃仁 桂枝 大黄 芒硝 甘草
桃花汤: 赤石脂 干姜 粳米
桑螵蛸散: 人参 茯神 远志 石菖蒲 桑螵蛸 龙骨 龟板 当归
桑麻丸: 桑叶 黑芝麻
橘半枳术丸: 白术 枳实 橘皮 半夏
橘术丸: 即二味为丸
橘皮汤: 橘皮 生姜
橘皮竹茹汤: 橘皮 竹茹 大枣 生姜 甘草 人参
正气散: 藿香 紫苏 白芷 大腹皮 茯苓 白术 陈皮 半夏曲 厚朴 桔梗 甘草 姜 枣
水陆二仙丹: 金樱膏 芡实
河间桂苓甘露饮: 滑石 石膏 寒水石 甘草 白术 茯苓 泽泻 猪苓 肉桂
治中汤: 人参 甘草 白术 干姜 青皮 陈皮
泻白散: 桑皮 地骨皮 甘草 粳米
泽术汤: 泽泻 白术
洁古芍药汤: 芍药 归尾 黄芩 黄连 大黄 木香 槟榔 甘草 肉桂
活络丹: 川乌 草乌 胆星 地龙 乳香 没药
济生固精丸: 牡蛎 菟丝子 韭子 龙骨 北五味 桑螵蛸 白石脂 茯苓
济生肾气丸: 即八味丸加车前牛膝
浚川丸: 黑牵牛 大黄 甘遂 芒硝 郁李仁 木香
浚川散: 黑牵牛 大黄 甘遂 芒硝 郁李仁 木香
海粉丸: 蛤粉 瓜蒌实 杏仁（各一两） 广皮 紫苏（各二两） 白术 土贝母（各四两） 紫菀 （三两） 木香（五钱）
海蛤丸: 天冬 瓜蒌霜 海浮石 蛤粉 风化硝 桔梗 橘红 香附 竹沥 姜汁
清六丸: 滑石 甘草 红曲
清心莲子饮: 石莲肉 人参 黄芪 茯苓 柴胡 黄芩 地骨皮 麦冬 车前 甘草
清暑益气汤: 人参 黄芪 白术 苍术 青皮 陈皮 神曲 甘草 麦冬 五味 当归 黄柏 泽泻 升麻 葛根 加姜枣
清燥救肺汤: 经霜桑叶（三钱） 杏仁（七分去皮尖炒黄） 麦冬（一钱二分去心） 石膏（二钱半） 人参（七分） 阿胶（八分） 胡麻仁（一钱炒） 甘草（一钱） 枇杷叶（一片去毛筋）
清骨散: 银柴胡 胡黄连 秦艽 鳖甲 地骨皮 青蒿 知母 甘草
温胃饮: 人参 白术 炮姜 扁豆 当归 陈皮 炙草
温胆汤: 陈皮 半夏 茯苓 甘草 枳实 竹茹
温脾汤: 干姜 肉桂心 熟附子 炙草 枳实 厚朴（各二两） 大黄（四钱）
滋燥养营汤: 当归 生地 熟地 白芍 甘草 黄芩 秦艽 防风
滋肾丸: 黄柏 知母 肉桂
滚痰丸: 青礞石 沉香 大黄 黄芩 焰硝
炙甘草汤: 炙草 桂枝 人参 麻仁 生地 阿胶 麦冬 生姜 大枣
牛黄膏: 牛黄（二钱半） 朱砂 郁金 丹皮（各三钱） 冰片（一钱） 甘草（一钱）
牡蛎泽泻散: 牡蛎 泽泻 海藻 蜀漆 葶苈 商陆根 瓜蒌根
犀角地黄汤: 犀角 生地 白芍 丹皮
猪肚丸: 白术 苦参 牡蛎 猪肚一具
猪肤汤: 猪肤 白蜜 白粉
猪苓汤: 猪苓 茯苓 泽泻 阿胶 滑石
玄参升麻汤: 玄参 升麻 僵蚕 牛蒡 连翘 防风 黄芩 黄连 桔梗 甘草
玉女煎: 生石膏 熟地 麦冬 知母 牛膝
玉屏风散: 黄芪 防风 白术
玉真丸: 硫黄 硝石 石膏 半夏 姜汁糊丸
玉钥匙: 马牙硝（一两半） 硼砂（五钱） 白僵蚕（一钱半） 冰片（一字）
王荆公妙香散: 人参 龙骨 益智仁 茯神 茯苓 远志 甘草 朱砂
理中丸: 人参 甘草 白术 干姜
理中安蛔丸: 人参 白术 干姜 茯苓 川椒 乌梅
理中汤: 人参 甘草 白术 干姜
理阴煎: 熟地 当归 炙甘草 干姜
琥珀黑龙丹: 即黑龙丹
琼玉膏: 地黄 茯苓 人参 白蜜
瓜蒂散: 瓜蒂 赤小豆 香豉
瓜蒌薤白白酒汤: 瓜蒌实 薤白 白酒
甘草小麦大枣汤: 甘草 小麦 大枣
甘草汤: 生甘草
甘草泻心汤: 甘草 干姜 半夏 黄芩 黄连 大枣 人参
甘遂半夏汤: 甘遂 半夏 芍药 甘草（一本无）
甘露饮: 生地 熟地 天冬 麦冬 石斛 茵陈 黄芩 枳壳 枇杷叶 甘草
生姜半夏汤: 半夏 生姜汁
生姜泻心汤: 生姜 干姜 半夏 黄芩 黄连 甘草 人参 大枣
生姜甘草汤: 生姜 人参 甘草 大枣
生脉六味丸: 人参 麦冬 五味 熟地 山药 山茱萸 丹皮 茯苓 泽泻
生脉六味汤: 人参 麦冬 五味 熟地 山药 山茱萸 丹皮 茯苓 泽泻
生脉四君子汤: 人参 麦冬 五味 人参 茯苓 白术 甘草
生脉散: 人参 麦冬 五味
白头翁汤: 白头翁 秦皮 黄连 黄柏
白散: 桔梗 贝母 巴豆
白蒺藜丸: 白蒺藜 山栀 大豆黄卷
白虎加人参汤: 石膏 知母 甘草 粳米 人参
白虎加桂枝汤: 石膏 知母 甘草 粳米 桂枝
白虎加苍术汤: 石膏 知母 甘草 粳米 加苍术
白虎汤: 石膏 知母 甘草 粳米
白通加猪胆汁汤: 葱白 干姜 附子 猪胆汁 人尿
白通汤: 葱白 干姜 附子
白金丸: 白矾 郁金
益元散: 滑石 甘草 辰砂
真武丸: 茯苓 白芍 白术 附子 生姜 作丸
真武汤: 茯苓 白芍 白术 附子 生姜
石刻安肾丸: 附子 肉桂 川乌 川椒 巴戟 菟丝子 破故 赤石脂 远志 茯神 茯苓 苍术 山茱萸 杜仲 胡芦巴 石斛 韭子 小茴 苁蓉 柏子仁 川楝子 鹿茸 青盐 山药
神保丸: 木香 胡椒 干蝎 巴豆
禹余粮丸: 蛇含石（本草名蛇黄大者三两醋煅透） 禹余粮石（三两层数多者佳醋煅透） 钢针砂（五两醋煅透）羌活 川芎 三棱 蓬术 白蔻 白蒺 陈皮 青皮 木香 大茴（炒） 牛膝 当归 炮姜 附子（炮） 肉桂（各五钱）
禹功丸: 黑牵牛 茴香
禹功散: 黑牵牛 茴香
禹粮石脂丸: 即二味为丸
秘元煎: 人参 茯苓 白术 炙草 枣仁 山药 芡实 五味 远志 金樱子
秫米半夏汤: 秫米 半夏
竹叶石膏汤: 竹叶 石膏 人参 麦冬 半夏 甘草 粳米
紫金丹: 牛黄 冰片 狗宝 鸦片（各六分） 广木香（二两）
紫雪丹: 黄金 寒水石 石膏 滑石 磁石 升麻 玄参 甘草 犀角 羚羊角 沉香 木香 丁香 朴硝 硝石 辰砂 麝香
缪仲淳脾肾双补丸: 人参 莲肉（炒） 山萸（烘） 山药（炒各一斤） 五味子（蜜蒸） 菟丝子（各一斤半） 橘红 砂仁（炒各六两） 车前子（米泔洗） 巴戟肉（甘草汁煮各十二两） 肉豆蔻（十两） 补骨脂（盐水浸二日炒一斤）
聚精丸: 黄鱼螵胶（一斤切碎蛤粉炒） 沙苑蒺藜（八两马乳浸隔汤煮一炷香）
胃关煎: 熟地 白术 山药 扁豆 炮姜 吴萸 炙草
胃苓散: 苍术 厚朴 陈皮 甘草 猪苓 茯苓 泽泻 白术 桂枝
胶艾四物汤: 生地 当归 白芍 川芎 阿胶 艾叶
脾约丸: 大黄 杏仁 厚朴 麻仁 枳实 芍药
至宝丹: 犀角（镑） 朱砂（研水飞） 雄黄（研水飞） 琥珀（研） 玳瑁（各一两镑） 水安息香 （一两无灰酒熬成膏如无以旱安息香代之） 西牛黄（五钱） 麝香（一钱） 龙脑（一钱） 金银箔（各五十片）
舒筋汤: 赤芍 海桐皮 当归 白术（各钱半） 片姜黄（二钱） 羌活 炙草（各一钱）沉香
芎归汤: 川芎 当归
花蕊石散: 花蕊石（四两） 硫黄（一两）
苍术石膏汤: 苍术 石膏 知母 甘草
苍耳散: 白芷 薄荷 辛夷 苍耳
苏合香丸: 苏合香 安息香 犀角 冰片 射香 香附 木香 薰陆香 沉香 丁香 白术
苓术菟丝丸: 茯苓 白术 菟丝子 莲肉 山药 炙草 五味子 杜仲
苓桂术甘汤: 茯苓 白术 桂枝 炙草
茅术理中汤: 人参 甘草 茅术 干姜
茯苓桂枝汤: 桂枝 白芍 炙草 生姜 大枣 茯苓
茯菟丸: 茯苓 菟丝子 建莲
茵陈四逆汤: 附子 干姜 炙草 茵陈
萆薢厘清饮: 川萆薢 石菖蒲 乌药 益智仁 甘草梢 食盐 茯苓
葛根芩连汤: 葛根 甘草 黄芩 黄连
葱白丸: 熟地（四两） 白芍 当归 川楝子 茯苓（各二两） 川芎 枳壳 厚朴 青皮 神曲 麦芽（各一两半） 三棱 蓬术（各一两） 干姜 大茴 木香（各七钱） 肉桂（五钱）
葱白丸: 人参 阿胶 川芎 当归 厚朴 葱白汁
葱豉汤: 葱白 淡豆豉
葶苈大枣泻肺汤: 葶苈 大枣
蒲黄酒: 蒲黄 清酒
藿香正气散: 藿香 紫苏 白芷 大腹皮 茯苓 白术 陈皮 半夏曲 厚朴 桔梗 甘草 姜 枣
虎杖散: 杜牛膝根汁（二三两，古方本用虎杖草汁，今人不识此草，故以土牛膝根汁，代之） 当门子麝香（一分，研）
虎潜丸: 熟地 虎胫骨 龟板 黄柏 知母 琐阳 当归 牛膝 白芍 陈皮 羯羊肉
蜡矾丸: 黄蜡 白矾
补中益气汤: 人参 黄芪 白术 甘草 陈皮 当归 升麻 柴胡 生姜 大枣
补心丸: 生地 人参 玄参 丹参 枣仁 远志 茯神 柏子仁 天冬 麦冬 当归 五味 桔梗 石菖蒲 辰砂
补血汤: 黄芪 当归
补阴益气煎: 人参 当归 山药 熟地 陈皮 炙草 升麻 柴胡 生姜
调中益气汤: 人参 黄芪 甘草 陈皮 升麻 柴胡 生姜 大枣 木香 苍术
贞元饮: 熟地 炙草 当归
资生丸: 人参 白术（土炒） 苡仁（各三两） 山楂肉 神曲 橘红（各二两） 扁豆 莲肉 厚朴（各一两） 山药 茯苓 麦芽 芡实（各一两半） 桔梗 甘草（炙） 藿香（各五钱） 泽泻 川黄连 白豆蔻（各三钱半）
赤石脂丸: 蜀椒 乌头 附子 炮姜 赤石脂
越婢汤: 麻黄 石膏 甘草 生姜 大枣
越鞠丸: 香附 苍术 川芎 神曲 山栀
还少丹: 熟地 山药 牛膝 枸杞 山萸 茯苓 杜仲 远志 五味子 楮实 小茴 巴戟 苁蓉 石菖蒲
进退黄连汤: 川黄连（姜汁炒一钱半） 干姜（炮一钱半） 人参（人乳拌蒸一钱半） 桂枝（一钱） 半夏（姜制一钱半） 大枣
连理汤: 人参 甘草 白术 干姜 黄连 茯苓
逍遥散: 柴胡 当归 白芍 白术 茯苓 甘草 煨姜 薄荷
通圣散: 防风 荆芥 麻黄 连翘 薄荷 川芎 当归 白芍 白术 山栀 大黄 芒硝 黄芩 石膏 桔梗 甘草 滑石 姜 葱
通幽汤: 当归 升麻 桃仁 红花 甘草 生地 熟地
通气防风汤: 柴胡 升麻 黄芪（各一钱） 防风 陈皮 羌活 人参 甘草（各五分） 藁本 青皮（各三分） 蔻仁（二分） 黄柏（一分）
通脉四逆加猪胆汁汤: 甘草 干姜 附子 葱白 猪胆汁
通脉四逆汤: 甘草 干姜 附子 葱白
都气丸: 熟地 山药 山茱萸 丹皮 茯苓 泽泻 五味子
酸枣仁汤: 枣仁 甘草 知母 茯苓 川芎
金刚丸: 萆薢 杜仲 肉苁蓉 菟丝子
金铃子散: 金铃子 延胡索
钱氏益黄散: 陈皮 青皮 诃子肉 炙草 丁香
防己茯苓汤: 防己 黄芪 桂枝 茯苓 甘草
防风通圣散: 防风 荆芥 麻黄 连翘 薄荷 川芎 当归 白芍 白术 山栀 大黄 芒硝 黄芩 石膏 桔梗 甘草 滑石 姜 葱
阿魏丸: 阿魏（七钱） 鳖甲（二两） 黄芪 广皮 枳实 柴胡 白术（各一两） 青皮 草果 黄芩 当归 茯苓（各八钱） 白蔻仁（七钱） 山楂（一两） 神曲（一两） 延胡
阿魏丸: 阿魏 连翘 胡黄连 山楂 青皮 山棱 蓬术 陈皮 半夏 麦芽 厚朴 莱菔子 甘草
附子泻心汤: 附子 黄芩 黄连 大黄
附子理中汤: 人参 甘草 白术 干姜 附子
附子粳米汤: 附子 半夏 甘草 粳米 大枣
附都气丸: 熟地 山药 山茱萸 丹皮 茯苓 泽泻 五味子，附子
陈无择六神散: 人参 茯苓 白术 甘草 山药 扁豆
震灵丹: 禹粮石 赤石脂 紫石英 代赭石（各四两）乳香（二两） 没药（二两） 朱砂（水飞一两） 五灵脂（二两）
露姜饮: 人参 生姜
青囊斑龙丸: 鹿角胶 鹿角霜 柏子仁 菟丝子 熟地 茯苓 补骨脂
香砂异功散: 人参 茯苓 白术 甘草 陈皮 木香 砂仁
驻车丸: 黄连 阿胶 干姜 当归
鳖甲煎丸: 鳖甲 乌扇 黄芩 柴胡 鼠妇 干姜 大黄 芍药 桂枝 葶苈 石苇 厚朴 丹皮 瞿麦 紫威 半夏 人参 土鳖虫 阿胶 蜂窠 赤硝 蜣螂 桃仁 灶下灰 清酒
鸡金散: 鸡内金 沉香 砂仁 陈香橼皮
麦门冬汤: 麦冬 半夏 人参 甘草 大枣 粳米
麻黄人参芍药汤: 桂枝 麻黄 黄芪 炙草 白芍 人参 麦冬 五味 当归
麻黄杏仁甘草石膏汤: 麻黄 杏仁 甘草 石膏
黄芩汤: 黄芩 白芍 甘草 大枣
黄芪建中汤: 白芍 桂枝 炙草 生姜 大枣 饴糖 黄芪
黄连温胆汤: 陈皮 半夏 茯苓 甘草 枳实 竹茹 黄连
黄连竹茹橘皮半夏汤: 黄连 竹茹 橘皮 半夏
黄连阿胶汤: 黄芩 黄连 白芍 阿胶 鸡子黄
黑地黄丸: 苍术 熟地 五味 干姜
黑锡丹: 黑铅 硫黄
